21,1,1,21,21,21,21,21,21,21,21,21,21,21,21,21
21,1,1,1,1,1,1,1,1,1,1,1,1,1,1,21
21,1,1,1,1,1,1,1,1,1,1,1,1,1,1,21
21,1,1,1,1,1,1,1,1,1,1,1,1,1,1,21
21,1,1,1,1,1,1,1,1,1,1,1,1,1,1,21
21,1,1,1,1,1,1,1,1,1,1,1,1,1,1,21
21,1,1,1,1,1,1,1,1,1,1,1,1,1,1,21
21,1,1,1,1,1,3,3,3,3,1,1,1,1,1,21
21,1,1,1,1,1,3,3,3,3,1,1,1,1,1,21
21,1,1,1,1,1,3,3,3,3,1,1,1,1,1,21
21,1,1,1,1,1,3,3,3,3,1,1,1,1,1,21
21,21,21,21,21,21,21,21,21,21,21,21,21,21,21,21